{
    "1": 300,
    "2": 245,
    "3": 195,
    "4": 155,
    "5": 135,
    "6": 110,
    "7": 97,
    "8": 85,
    "9": 75,
    "10": 64,
    "11": 56,
    "12": 48,
    "13": 42,
    "14": 36,
    "15": 33,
    "16": 30,
    "17": 24,
    "18": 24,
    "19": 21,
    "20": 18,
    "21": 15,
    "22": 12,
    "23": 10,
    "24": 8,
    "25": 6,
    "26": 4,
    "27": 3,
    "28": 2,
    "29": 1
}
